111111111111111111111111111111111111111111111111111
1P0000100000000000010C000000000000000010000000000C1
101111011111011111011111011111111111111011111111101
100000010000010000010000010000000000001000000000001
101110111110111011101110111111011111111111111111101
100010000010000010000010000010000000000000000000001
101011111011111011111011111011111111111111111111101
100010000000000000000010000000000000000000000000001
101111111111111111111111111111111111111111111111101
100000000000000000000000000000000000000000000000001
101111111111111111111111111111111111111111111111101
10000000000000000000000000001000000000000000000C001
111111111110111111111111111111111111111111111111101
100000000000000001000000100000000000000000000000001
101111111111111111111110111111111111111111111111101
10000000000001C000000000100000000000000000000000001
101111111111111110111111111111111111111111111111101
10000000000000000000C000000000000000000000000000001
101111111111111111111011111111111111111111111111111
100000000000000000110001111000000000000000000000001
1000001000000000000000000000000000000010000000000C1
101111011111011111011111011111111111111011111111101
100000010000010000010000010000000000001000000000001
101110111110111011001110111111011111111111111111101
10100000001000001C00000000001000000000C000000000001
101010111011111011111011111011111111111111111111101
100010E10000000000000010000000000000000000000000001
111111111111111111111111111111111111111111111111111
