111111111111111111111111111111111111111111111111111
1P00001000000000000100000000000000000010000000000C1
101111011111011111011111011111111111111011111111101
100000010000010000010000010000000000001000000000001
101110111110111011101110111111011111111111111111101
100010000010000010000010000010000000000000000000001
101011111011111011111011111011111111111111111111101
100010000000000000000010000000000000000000000000001
101111111111111111111111111111111111111111111111101
100000000000000000000000000000000000000000000000001
101111111111111111111111111111111111111111111111101
10000000000000000000000000000000000000000000000C001
111111111111111111111111111111111111111111111111101
100000000000000000000000000000000000000000000000001
101111111111111111111111111111111111111111111111101
100000000000000000000000000000000000000000000000001
101111111111111111111111111111111111111111111111101
10000000000000000000C000000000000000000000000000001
101111111111111111111111111111111111111111111111101
100000000000000000000000000000000000000000000000001
101111111111111111111111111111111111111111111111101
10000000000000000000000000000000000000C000000000001
101111111111111111111111111111111111111111111111101
1000000000000000000000000000000000000000000000000C1
111111111111111111111111111111111111111111111111101
10000000000000000000000000000000C0000000000000000E1
111111111111111111111111111111111111111111111111111